111111111111111
1P0001000000001
111101001010001
101001000010001
101000001110001
1000001100C0001
100100010011001
1000C0010000001
100001000111101
100001000000001
111110000000111
111000000011111
100001000000001
111101001010001
101001000010001
101000001110001
1000001100C0001
100100010011001
1000C001B000001
100001000111101
1000010000000E1
111111111111111
